R  5050  5050
NO textures/bookshelf.xpm
SO textures/crafting_table_top.xpm
WE textures/planks_oak.xpm
EA textures/planks_spruce.xpm

S textures/barrel.xpm
F 000,100,0
C 005,30,0

        1111111111111111111111111
        1000000000110000000000001
        1011000001110000000000001
        1001000000000000000000001
111111111011000001110000000000001
100000000111000001110111111111111
1111011111 111011100000000001
1111011111 111011101010010001
11000000111101011100000010001
10000000000000001100000010001
10000000000000001101010010001
11000001110101011111011110N0111
11110111 1110101 101111010001
11111111 1111111 111111111111
