R 1920 1080
NO ../resources/north
SO ../resources/south
WE ../resources/west
EA ../resources/east
S ../resources/sprite1
F 225,0,0
C 0,0,255

1 1 1 1 1 1 1 1 1 1
1 0 0 0 1 1 1 0 0 1
1 0 0 0 0 1 0 0 1 1
1 0 0 0 0 1 0 1 1 1
1 0 1 0 1 1 0 0 0 1
1 0 1 0 1 1 1 1 1 1
1 1 1 0 1 1 1 1 0 1
1 0 0 0 0 0 1 0 0 1
1 0 0 0 0 0 0 0 S 1
1 1 1 1 1 1 1 1 1 1