R     10000      1000
NO   textures/bookshelf.xpm

SO textures/crafting_table_top.xpm
   WE textures/planks_oak.xpm
EA textures/planks_spruce.xpm

S textures/barrel.xpm
F 50, 156, 31
C     53, 189, 219

1111111
1100021
1200001
1000001
1001001
101 101
1001001
1000001
1000001
12000N1
1111111
